4444444444444444444444444444444444444444444444444444444
4111111111111111111111111111111111111111111111111111114
4155555555555555555555510000000000155555555555155555514
4155555555555555555555510000000000955555555555955555514
4155555555555555555555510000000000955555555555955555514
4155555555555555555555510000000000155555555555155555514
4155555555555555555555510000000000155555555555155555514
4155555555555555555555510000000000155555555555155555514
4155555555555555555555510000000000155555555555155555514
4155555555555555555555510000000000155555555555155555514
4155555555555555555555510000000000155555555555155555514
4155555555555555555555510000000000155555555555155555514
4155555555555555555555510000010000011111111111111111114
4155555555555555555555510000000000000000000000000000024
4155555555555555555555510000000000000000000000000000024
4155555555555555555555510000000000000000000000000000024
4155555555555555555555510000000000000000000000000000024
4155555555555555555555510000000000000000000000000000024
4155555555555555555555510000010000000000000000000000024
4155555555555555555555510000000000000199111111111111114
4155555555555555555555510000000000000155955555555555514
4155555555555555555555510000000333333155955555555555514
4155555555555555555555510000000333333155155555555555514
4155555555555555555555510000000333333155155555555555514
4155555555555555555555510000000333333155111111111111114
4199991111111111111111110000000333333155955555555555514
4100000000000000000000000000000333333155955555555555514
4100000000000000000000000000000333333155955555555555514
4100000000000000000000000000000333333155955555555555514
4111111111111111111111111111111111111111111111111111114
4444444444444444444444444444444444444444444444444444444
