4444444444444444444444444444444444444444444444444444444
4111111111111111111111111111111111111111111111111111114
4155555555555555555555515555555555155555555555155555514
4155555555555555555555515555555555955555555555955555514
4155555555555555555555515555555555955555555555955555514
4155555555555555555555515555555555155555555555155555514
4155555555555555555555515555555555155555555555155555514
4155555555555555555555515555555555155555555555155555514
4155555555555555555555515555555555155555555555155555514
4155555555555555555555515555555555155555555555155555514
4155555555555555555555515555555555155555555555155555514
4155555555555555555555510000009999155555555555155555514
4155555555555555555555510000010000011111111111111111114
4155555555555555555555515555555555555900000000000000024
4155555555555555555555515555555555555900000000000000024
4155555555555555555555515555555555555900000000000000024
4155555555555555555555515555555555555900000000000000024
4155555555555555555555515555555555555900000000000000024
4155555555555555555555515555555555555900000000000000024
4155555555555555555555515555555555555199111111111111114
4155555555555555555555515555555555555155955555555555514
4155555555555555555555515555555555555155955555555555514
4155555555555555555555515555555555555155155555555555514
4155555555555555555555515555555555555155155555555555514
4155555555555555555555515555555555555199111111111111114
4199991111111111111111115555555555555155555555555555514
4155559000000000000000005555555555555155555555555555514
4155559000000000000000005555555555555155555555555555514
4155559000000000000000005555555555555155555555555555514
4111111111111111111111111111111111111111111111111111114
4444444444444444444444444444444444444444444444444444444
