4444444444444444444444444444444444444444444444444444444
4111111111111111111111111111111111111111111111111111114
4100000000000000000000010000000000100000000000100000014
4100000000000000000000010000000000000000000000000000014
4133000000000000000000010000000000000000000000000000014
4133000000303030303000010000000000100000000000100000014
4133000000303030303000010000000000100000000000100000014
4133000030303030303000010000000000100000000000100000014
4133000030303030303000010000000000100000000000100000014
4133000030303030303030310000000000100000000000100000314
4133000030303030303030310000000000100000000000100000314
4133000030303030303030310000000000110000000000100000314
4133000030303030303030310000010000011111111111111111114
4133000030303030303030310000000000000000000000000000024
4133000030303030303030310000000000000000000000000000024
4133000030303030303030310000000000000000000000000000024
4133000030303030303030310000000000000000000000000000024
4133000030303030303030310000000000000000000000000000024
4133000030303030303030310000010000000000000000000000024
4133000030303030303030310000000000000100111111111111114
4133000000303030303030310000000000000100000000000003314
4133000000303030303030310000000333333100000000000000314
4100000000000000000000010000000333333100100010331000014
4100000000000000000000010000000333333100100310031003014
4100000000000000000000010000000333333100111111111111114
4100001111111111111111110000000333333100000000000003314
4100000000000000000000000000000333333100000000000000314
4100000000000000000000000000000333333100000010331000014
4100000000000000000000000000000333333100333310031000314
4111111111111111111111111111111111111111111111111111114
4444444444444444444444444444444444444444444444444444444
