44444444444444444444444444444444444444444444444444444444444444444444444444444444444444444444444
44444444444111111111111111144444444444444444444444444111111111111111144444444444444444444444444
44444444444100000010000000144444444444444444444444444100000010000000144444444444444444444444444
44444111111100000010000000111111111111111111111111111100000010000000144444444444444444444444444
44444100000000000010000000000100001000010000100001000000000010000000111144444444444444444444444
44444100000000000010000000000100001000010000100001000000000010000000000144444444444444444444444
44444100000000000010000000000100001000010000100001000000000010000000000144444444444444444444444
44444100000000000010000000000100001000010000100001000000000010000000000144444444444444444444444
44444100000000000010000000000100001000010000100001000000000010000000000144444444444444444444444
44444100000000000010000000000100001000010000100001000000000010000000000144444444444444444444444
44444100000000000010000000000100001000010000100001000000000010000000000111111111111144444444444
44444100000000000010000000000100001000010000100001000000000010000000000100000000001114444444444
44444100000000000010000000000100001000010000100001000000000010000000000100000000000011444444444
44444100000000000010000000000100001000010000100001000000000010000000000100000000000001444444444
44111100000000000010000000000100001000010000100001000000000010000000000100000000000001144444444
44100100000000000010000000000100001000010000100001000000000010000000000100000000000001144444444
44100110011111100111001111001110011100111001110011100111100111001111001100000000000011144444444
44100000000000000000000000000000000000000000000000000000000000000000000100000000000110114444444
44100000000000000000000000000000000000000000000000000000000000000000000110000000001100011444444
44100000000000000000000000000000000000000000000000000000000000000000000010000000011000001144444
44100000000000000000000000000000000000000000000000000000000000000000000000000000110000000114444
44100000000000000000000000000000000000000000000111000011111111110000000000001001100000000011444
44100001111111110001110000111110000110000000000100000000000000011000000000001111000000000001144
44100001000100010001000000000000000010000000000100000000000000001100000000000110000000000000144
44100001000100010001000000000000000010000000000100000000000000000000000000000011000000000000144
44100001000100010001000000000000000010000000000100000000000000000000000000000001000000000000144
44100001000100010001000000000011111110000000000100000000000000000000100000000000000000000000144
44100001001110011111000000000014444200000000000100000000000000000000110000000000000000000000144
44100000000000000000000000000014444200000000000100000000000000000000011000000000000000000001144
44100000000000000000000000000014444200000000000111111100000000000000001000000000001100000011444
44111001111110011111000000000014411100000000000100100100000000000000001000000000000110000114444
44100000000000001441000000000014444100000111111100100111111100111111111000000000000011001144444
44100000000000001441000000000014444100000100000000000000000000000000000000000000000001111444444
44111110000000001441000000000014444100000100000000000000000000000000000000000000000002444444444
44444410000000001441000000000014444100000100000000000000000000000000000000000000000002444444444
44444410000000001441000000000014444100000000000000000000000000000000000000000000000002444444444
44444410000000001441000000000014444100000000100111110011111111110001111111111111111111444444444
44444410000000001441000000000014444100000000100001000010000000000000000000001444444444444444444
44444411111100001441000000111114444111100000100001000010000000000000000000001444444444444444444
44444444444100001441000000144444444444100000100001000010000000010001000000001444444444444444444
44444444444100001441000000144444444444100000100001000010000000010001000000001444444444444444444
44444444444111111441111111144444444444111111111111111110000000010001000000001444444444444444444
44444444444444444444444444444444444444444444444444444410000000010001000000001444444444444444444
44444444444444444444444444444444444444444444444444444410000000010001000000001444444444444444444
44444444444444444444444444444444444444444444444444444410000000000000000000001444444444444444444
44444444444444444444444444444444444444444444444444444410000000000000000000001444444444444444444
44444444444444444444444444444444444444444444444444444411111111110001111111111444444444444444444
44444444444444444444444444444444444444444444444444444410000000000000000000001444444444444444444
44444444444444444444444444444444444444444444444444444410000000000000000000001444444444444444444
44444444444444444444444444444444444444444444444444444410000000010001000000001444444444444444444
44444444444444444444444444444444444444444444444444444410000000010001000000001444444444444444444
44444444444444444444444444444444444444444444444444444410000000010001000000001444444444444444444
44444444444444444444444444444444444444444444444444444410000000010001000000001444444444444444444
44444444444444444444444444444444444444444444444444444410000000010001000000001444444444444444444
44444444444444444444444444444444444444444444444444444410000000000000000000001444444444444444444
44444444444444444444444444444444444444444444444444444410000000000000000000001444444444444444444
44444444444444444444444444444444444444444444444444444411111111110001111111111444444444444444444
44444444444444444444444444444444444444444444444444444410000000000000000000001444444444444444444
44444444444444444444444444444444444444444444444444444410000000000000000000001444444444444444444
44444444444444444444444444444444444444444444444444444410000000010001000000001444444444444444444
44444444444444444444444444444444444444444444444444444410000000010001000000001444444444444444444
44444444444444444444444444444444444444444444444444444410000000010001000000001444444444444444444
44444444444444444444444444444444444444444444444444444410000000010001000000001444444444444444444
44444444444444444444444444444444444444444444444444444410000000010001000000001444444444444444444
44444444444444444444444444444444444444444444444444444410000000000000000000001444444444444444444
44444444444444444444444444444444444444444444444444444410000000000000000000001444444444444444444
44444444444444444444444444444444444444444444444444444411111111112221111111111444444444444444444
44444444444444444444444444444444444444444444444444444444144444444444444444144444444444444444444
44444444444444444444444444444444444444444444444444444444144444444444444444144444444444444444444
44444444444444444444444444444444444444444444444444444444111111111111111111144444444444444444444
44444444444444444444444444444444444444444444444444444444444444444444444444444444444444444444444
