44444444444444444444444444444444444444444444444444444444444444444444444444444444444444444444444444444444444444444444
44111111111111111111111111111112211111111221111111122111111111111111111122111111111111112211111111111111111111111114
44111111111111111111111111111110011111111001111111100111111111111111111100111111111111110011111111111111111111111114
44111100111100000000000000000000000000000000000000000000000001100000000000000000000110000000011000000000000000000114
44110000001100000000000000000000000000000000000000000000000001100000000000000000000110000000011000000000000000000114
44110000001100000000000000000000000000000000000000000000000001100000000000000000000110000000011000000330000033000114
44110000001100000000000000000000000000000000000000000000000001100000000000000000000110000000000000000330000033000114
44110000001100000000000000000000000000000000000000000000000000000000000000000000000000000000000000000000000000000114
44110000001100000000000000000000000000000000000000000000000000000000000000000000000000000000000000000000000000000114
44110000001100000000000000000000000000000000000000000000000000000000000000000000000000000000000000000000000000000114
44110000001100000000000000000000000000000000000000000000000000000000000000000000000000000000011000000000000000000114
44110000001100000000000000000000000000000000000000000000000000000000000000000000000000000000011000000000000000000114
44110000001100000000000000000000000000000000000000000000000000000000000000000000000110000000011000000000000000000114
11111000011111111111111111100000000110000000110000000111111111100000000000000000000110000000011111111110011111111114
11111000011111111111111111100000000110000000110000000111111111110000011000001100000110000000011000000000000000000114
20000000000000000000000000000000000000000000000000000000000331110000011000001100000110000000011000000000000000000114
20000000000000000000000000000000000000000000000000000000000031100000000000000000000110000000011000000000000000000114
20000000000000000000000000000000003030303030303030303030300000000000000000000000000110000000011000000000000000000114
20000000000000000000000000000000003030303030303030303030300000000000000000000000000110000000011111111111111111111114
11000000000000000000000000000000003030303030303030303030300000000000000000000000333110000000011000000000000000000114
11000000000000000000000000000000003030303030303030303030300000000000000000000000333110000000011003300000000000000024
20000000000000000000000000000000000000000000000000000000000000000000000000000033333000000000011003300000000000000024
20000000000000000000000000000000000000000000000000000000000000000000000000000033333000000000011000000000000000000024
20000000000000000000000000000000000000000000000000000000000000000000000000000033333000000000011000000000000000000024
20000000000000000000000000000000000000000000000000000000000000000000000000000033333000000000011003300000000000000024
11000000000000000000000000000000003030303030303030303030300000000000000000000000333110000000011003300000000000000024
11000000000000000000000000000000003030303030303030303030300000000000000000000000333110000000011000000000000000000114
20000000000000000000000000000000003030303030303030303030300000000000000000000000000110000000011111111110011111111114
20000000000000000000000000000000003030303030303030303030300000000000000000000000000110000000000000000000000000000114
20000000000000000000000000000000000000000000000000000000000031100000000000000000000110000000000000000000000000000114
20000000000000000000000000000000000000000000000000000000000331110000011000001100000110000000000000000000000000000114
11111111111111111111111111100000000110000000110000000111111111110000011000001100000110000000000000000000000000000114
11111111111111111111111111100000000110000000110000000111111111100000000000000000000110000000011111111111111111111114
44110000000000000000000000000000000000000000000000000000000000000000000000000000000110000000011000000000000000000114
44110000000000000000000000000000000000000000000000000000000000000000000000000000000000000000011000000000000000000114
44110000000000000000000000000000000000000000000000000000000000000000000000000000000000000000011000033000330003300114
44110000000000000000000000000000000000000000000000000000000000000000000000000000000000000000000000033000330003300114
44110000000000000000000000000000000000000000000000000000000000000000000000000000000000000000000000000000000000000114
44110000000000000000000000000000000000000000000000000000000000000000000000000000000000000000000000000000000000000114
44110000000000000000000000000000000000000000000000000000000001100000000000000000000110000000000000000000000000000114
44110000000000000000000000000000000000000000000000000000000001100000000000000000000110000000011000033000330003300114
44110000000000000000000000000000000000000000000000000000000001100000000000000000000110000000011000033000330003300114
44110000000000000000000000000000000000000000000000000000000001100000000000000000000110000000011000000000000000000114
44111111111111111111111111111110011111111001111111100111111111111111111100111111111111110011111111111111111111111114
44111111111111111111111111111112211111111221111111122111111111111111111122111111111111112211111111111111111111111114
44444444444444444444444444444444444444444444444444444444444444444444444444444444444444444444444444444444444444444444
