11111111111111111111
10000000000100000001
10000000000100000001
10000000000100000001
10000000000100000001
11111111100100000001
10000000000000000001
10000000000000000002
10000000000000000002
10000000000000000002
10000000000000000002
10000000000000000001
11100111111100000001
10000001000100000001
10000001000100000001
10000000000100000001
10000000000100000001
10000001000100000001
10000001000100000001
11111111111111111111