4444444444444444444444444444444444444444444444444444444444444444444444444444444444444444
4111111111111111112221111122111221111111111111111111122111221111112221111111111111111114
4100000000000000000000000000000000000000000000000000000000000000000000000000000001555514
4100000000000000000000000000000000000000000000000000000000000000000000000000000001555514
4100000000000000000000000000000000000000000000000000000000000000000000000000000031555514
4100000000000000000000000000000000000000000000000000000000000000000000000000111111555514
4100000000000000000000000000000000000000000000000000000000000000000000001000111111999314
4100000000000000000000000000000000000000000000000000000000000000000000001000155555555514
4100000000000000000000000000000000000000000000000000000000000000000000001000155555555514
4100000000000000000000000000000000000000000000000000000000000000000000001000155555555514
4100000000000000000000000000000000000000000000000000000000000000000000001000155555555514
4100000000000000000000000000000000000000000000000000000000000000000000001000955555555514
4100000000000000000000000000000000000000000000000000000000000000000000001000955555555514
4100000000000000000000000000000000000000000000000000000000000000000000001000111111111114
4100000000000000000000000000000000000000000000000000000000000000000000001000955555555514
4100000000000000000000000000000000000000000000000000000000000000000000001000955555555514
4100000000000000000000000000000000000000000000000000000000000000000000001000155555555514
4100000000000000000000000000000000000000000000000000000000000000000000001000155555555514
4100000000000000000000000000000000000000000000000000000000000000000000001000155555555514
4100000000000000000000000000000000000000000000000000000000000000000000001000155555555514
4100000000000000000000000000000000000000000000000000000000000000000000001000155555555514
4100000000000000000000000000000000000000000000000000000000000000000000001000155555555514
4100000000000000000000000000000000000000000000000000000000000000000000000000155555555514
4100000000000000000000000000000000000000000000000000000000000000000000000000155555555514
4100000000000000000000000000000000000000000000000000000000000000000000000000155555555514
4100000000000000000000000000000000000000000000000000000000000000000000000000111111111114
4100000000000000000000000000000000000000000000000000000000000000000000000000000000000014
4100000000000000000000000000000000000000000000000000000000000000000000000000000000000014
4100000000000000000000000000000000000303030303030303030300000000000000000000000000000014
4100000000000000000000000000000000000303030303030303030300000000000000000000000000000014
4100000000000000000000000000000000000303030303030303030300000000000000000000000000000014
4100000000000000000000000000000000000303030303030303030300000000000000000000000000000014
4100000000000000000000000000000000000303030303030303030300000000000000000000000000000014
4100000000000000000000000000000000000303030303030303030300000000000000000000000000000014
4100000000001000000000000000000000000000000000000000000000000000000000000000000000000014
4100000000001000000000000000000000000000000000000000000000000000000000000000000000000014
4100000000001000000000000000000000000000000000000000000000000000000000000000000000000014
4100000000001000000000000000000000000000000000000000000000000000000000000000000000000014
4100000000001000000000000000000000000000000000000000000000000000000000000000000000000014
4100000000001000000000000000000000000000000000000000000000000000000000000000000000000014
4100000000001000000000000000000000000303030303030303030300000000000000000000000000199914
4100000000001000000000000000000000000303030303030303030300000000000000000000000000100014
4100000000001000000000000000000000000303030303030303030300000000000000000000000000100014
4100000000001000000000000000000000000303030303030303030300000000000000000000000000100014
4100000000001000000000000000000000000303030303030303030300000000000000000000000000100014
4100000000001000000000000000000000000303030303030303030300000000000000000000000000100024
4100000000001000000000000000000000000000000000000000000000000000000000000000000000100024
4100000000001000000000000000000000000000000000000000000000000000000000000000000000100024
4100000000001000000000000000000000000000000000000000000000000000000000000000111111100014
4100000000001000000000000000000000000000000000000000000000000000000000000000100000000014
4100000000001000000000000000000000000000000000000000000000000000000000000000100000000014
4100000000000000000000000000000000000000000000000000000000000000000000000000100000000014
4100000000000000000000000000000000000000000000000000000000000000000000000000100000000014
4100000000000000000000000000000000000000000000000000000000000000000000000000100011111114
4100000000000000000000000000000000000000000000000000000000000000000000000000100095555514
4100000000000000000000000000000000000000000000000000000000000000000000000000100095555514
4100000000000000000000000000000000000000000000000000000000000000000000000000100015555514
4100000000000000000000000000000000000000000000000000000000000000000000000000111111111114
4100000000000000000000000000000000000000000000000000000000000000000000000000155595555514
4100000000000000000000000000000000000000000000000000000000000000000000000000155595555514
4100000000000000000000000000000000000000000000000000000000000000000000000000155515555514
4100000000000000000000000000000000000000000000000000000000000000000000000000155511111114
4100000000000000000000000000000000000000000000000000000000000000000000000000155515555514
4100000000000000000000000000000000000000000000000000000000000000000000000000155595555514
4100000000000000000000000000000000000000000000000000000000000000000000000000155595555514
4100000000000000000000000000000000000000000000000000000000111111111111111111199911111114
4100000000000000000000000000000000000000000000000000000000100000000000000000000033333314
4100000000000000000111111111111111111111111111111111100000100000000000000000000000000014
4100000000000000000155555555555555555555555555555555500000100000000000000000000000000024
4100000000000000000155555555555555555555555555555555500000100000000000000000000000000024
4100000000000000000155555555555555555555555555555555511111100000000000000000000000000024
4100000000000000000155555555555555555555555555555555590000000000000000000000000000000314
4100000000000000000155555555555555555555555555555555590000000000000000000000000000000314
4100000000000000000155555555555555555555555555555555590000000000000000000000000000000314
4100000000000000000155555555555555555555555555555555500000000000033333333333333333333314
4111111111111222111111111111111111111111111111111111111111111111111111111111111111111114
4444444444444444444444444444444444444444444444444444444444444444444444444444444444444444