4444444444444444444444444444444444444444444444444444444444444444444444444444444444444444444444444444
4111111111111111111111111111111111111111111111111111111111111111111111111111111122221111111111111114
4100000000000000000000000000000000000000000000000000000000000000000000000000000000000000000000000014
4100000000000000000000000000000000000000000000000000000000000000000000000000000000000000000000000014
4100000000000000000000000000000000000000000000000000000000000000000000000000000000000000000000000014
4100000000000000000000000000000000000000000000000000000000000000000000000000000000000000000000000014
4100000000000000000000000000000000000000000000000000000000000000000000000000000000000000000000000014
4100000000000000000000000000000000000000000000000000000000000000000000000000000000000000000000000014
4100000000000000000000000000000000000000000000000000000000000000000000000000000000000000000000000014
4100000000000000000000000000000000000000000000000000000000000000000000000000000000000000000000000014
4100000000000000000000000000000000000000000000000000000000000000000000000000000000000000000000000014
4100000000000000000000000000000000000000000000000000000000000000000000000000000000000000000000000014
4100000000000000000000000000000000000000000000000000000000000000000000000000000000000000000000000014
4100000000000000000000000000000000000000000000000000000000000000000000000000000000000000000000000014
4100000000000000000000000000000000000000000000000000000000000000000000000000000000000000000000000014
4100000000000000000000000000000000000000000000000000000000000000000000000000000000000000000000000014
4100000000000000000000000011111111111111111111111111111111111111111111111111110000000000000000000014
4100000000000000000000000011111111111111111111111111111111111111111111111111110000000000000000000014
4100000000000000000000000011111111111111111111111111111111111111111111111111110000000000000000000014
4100000000000000000000000011111111111111111111111111111111111111111111111111110000000000000000000014
4100000000000000000000000011111111111111111111111111111111111111111111111111110000000000000000000014
4100000000000000000000000011111111111111111111111111111111111111111111111111110000000000000000000014
4100000000000000000000000011111111111111111111111111111111111111111111111111110000000000000000000014
4100000000000000000000000011111111111111111111111111111111111111111111111111110000000000000000000014
4100000000000000000000000011111111111111111111111111111111111111111111111111110000000000000000000014
4100000000000000000000000011111111111111111111111111111111111111111111111111110000000000000000000014
4100000000000000000000000011111111111111111111111111111111111111111111111111110000000000000000000014
4100000000000000000000000011111111111111111111111111111111111111111111111111110000000000000000000014
4100000000000000000000000011111111111111111111111111111111111111111111111111110000000000000000000014
4100000000000000000000000011111111111111111111111111111111111111111111111111110000000000000000000014
4100000000000000000000000000000000000000000000000000000000000000000000000000000000000000000000000014
4100000000000000000000000000000000000000000000000000000000000000000000000000000000000000000000000014
4100000000000000000000000000000000000000000000000000000000000000000000000000000000000000000000000014
4100000000000000000000000000000000000000000000000000000000000000000000000000000000000000000000000014
4100000000000000000000000000000000000000000000000000000000000000000000000000000000000000000000000014
4100000000000000000000000000000000000000000000000000000000000000000000000000000000000000000000000014
4100000000000000000000000000000000000000000000000000000000000000000000000000000000000000000000000014
4100000000000000000000000000000000000000000000000000000000000000000000000000000000000000000000000014
4100000000000000000000000000000000000000000000000000000000000000000000000000000000000000000000000014
4100000000000000000000000000000000000000000000000000000000000000000000000000000000000000000000000014
4100000000000000000000000000000000000000000000000000000000000000000000000000000000000000000000000014
4100000000000000000000000000000000000000000000000000000000000000000000000000000000000000000000000014
4100000000000000000000000000000000000000000000000000000000000000000000000000000000000000000000000014
4100000000000000000000000000000000000000000000000000000000000000000000000000000000000000000000000014
4100000000000000000000000000000000000000000000000000000000000000000000000000000000000000000000000014
4100000000000000000000000000000000000000000000000000000000000000000000000000000000000000000000000014
4100000000000000000000000000000000000000000000000000000000000000000000000000000000000000000000000014
4100000000000000000000000000000000000000000000000000000000000000000000000000000000000000000000000014
4100000000000000000000000000000000000000000000000000000000000000000000000000000000000000000000000014
4100000000000000000000000000000000000000000000000000000000000000000000000000000000000000000000000014
4100000000000000000000000000000000000000000000000000000000000000000000000000000000000000000000000014
4100000000000000000000000000000000000000000000000000000000000000000000000000000000000000000000000014
4100000000000000000000000000000000000000000000000000000000000000000000000000000000000000000000000014
4100000000000000000000000000000000000000000000000000000000000000000000000000000000000000000000000014
4100000000000000000000000000000000000000000000000000000000000000000000000000000000000000000000000014
4100000000000000000000000000000000000000000000000000000000000000000000000000000000000000000000000014
4100000000000000000000000000000000000000000000000000000000000000000000000000000000000000000000000014
4100000000000000000000000000000000000000000000000000000000000000000000000000000000000000000000000014
4100000000000000000000000011111111111111111111111111111111111111111111111111110000000000000000000014
4100000000000000000000000011111111111111111111111111111111111111111111111111110000000000000000000014
4100000000000000000000000011111111111111111111111111111111111111111111111111110000000000000000000014
4100000000000000000000000011111111111111111111111111111111111111111111111111110000000000000000000014
4100000000000000000000000011111111111111111111111111111111111111111111111111110000000000000000000014
4100000000000000000000000011111111111111111111111111111111111111111111111111110000000000000000000014
4100000000000000000000000011111111111111111111111111111111111111111111111111110000000000000000000014
4100000000000000000000000011111111111111111111111111111111111111111111111111110000000000000000000014
4100000000000000000000000011111111111111111111111111111111111111111111111111110000000000000000000014
4100000000000000000000000011111111111111111111111111111111111111111111111111110000000000000000000014
4100000000000000000000000011111111111111111111111111111111111111111111111111110000000000000000000014
4100000000000000000000000011111111111111111111111111111111111111111111111111110000000000000000000014
4100000000000000000000000011111111111111111111111111111111111111111111111111110000000000000000000014
4100000000000000000000000011111111111111111111111111111111111111111111111111110000000000000000000014
4100000000000000000000000011111111111111111111111111111111111111111111111111110000000000000000000014
4100000000000000000000000011111111111111111111111111111111111111111111111111110000000000000000000014
4100000000000000000000000011111111111111111111111111111111111111111111111111110000000000000000000014
4100000000000000000000000011111111111111111111111111111111111111111111111111110000000000000000000014
4100000000000000000000000011111111111111111111111111111111111111111111111111110000000000000000000014
4100000000000000000000000011111111111111111111111111111111111111111111111111110000000000000000000014
4100000000000000000000000011111111111111111111111111111111111111111111111111110000000000000000000014
4100000000000000000000000011111111111111111111111111111111111111111111111111110000000000000000000014
4100000000000000000000000011111111111111111111111111111111111111111111111111110000000000000000000014
4100000000000000000000000011111111111111111111111111111111111111111111111111110000000000000000000014
4100000000000000000000000011111111111111111111111111111111111111111111111111110000000000000000000014
4100000000000000000000000000000000000000000000000000000000000000000000000000000000000000000000000014
4100000000000000000000000000000000000000000000000000000000000000000000000000000000000000000000000014
4100000000000000000000000000000000000000000000000000000000000000000000000000000000000000000000000014
4100000000000000000000000000000000000000000000000000000000000000000000000000000000000000000000000014
4100000000000000000000000000000000000000000000000000000000000000000000000000000000000000000000000014
4100000000000000000000000000000000000000000000000000000000000000000000000000000000000000000000000014
4100000000000000000000000000000000000000000000000000000000000000000000000000000000000000000000000014
4100000000000000000000000000000000000000000000000000000000000000000000000000000000000000000000000014
4100000000000000000000000000000000000000000000000000000000000000000000000000000000000000000000000014
4100000000000000000000000000000000000000000000000000000000000000000000000000000000000000000000000014
4100000000000000000000000000000000000000000000000000000000000000000000000000000000000000000000000014
4100000000000000000000000000000000000000000000000000000000000000000000000000000000000000000000000014
4100000000000000000000000000000000000000000000000000000000000000000000000000000000000000000000000014
4100000000000000000000000000000000000000000000000000000000000000000000000000000000000000000000000014
4100000000000000000000000000000000000000000000000000000000000000000000000000000000000000000000000014
4111111111111111111111111111111111111111111111111111111111111111111111111111111111111111111111111114
4444444444444444444444444444444444444444444444444444444444444444444444444444444444444444444444444444